18 18 18 18 18 18 18 18 18 18 18 18 18 18 18 18 18 18 18 18 18 18 18 18 18 18 18 18 18 18 18 18 18 18 18 18 18 18 18 18 18 18 18 18 18 18 18 18 18 18
18 18 18 18 18 18 18 18 18 18 18 18 18 18 18 18 18 18 18 18 18 18 18 18 18 18 18 18 18 18 18 18 18 18 18 18 18 18 18 18 18 18 18 18 18 18 18 18 18 18
18 18 18 18 18 18 18 18 18 18 18 18 18 12 12 12 12 12 18 18 18 12 12 12 12 18 18 18 12 12 12 12 18 18 18 18 18 18 12 12 12 12 18 18 18 18 18 18 18 18
18 18 18 18 18 18 18 18 18 18 18 18 18 18 18 18 18 18 18 18 12 12 12 12 18 18 18 12 12 12 12 18 18 18 18 12 12 12 12 12 12 12 18 18 18 18 18 18 18 18
18 18 18 18 18 18 18 18 18 18 18 18 18 18 39 32 32 32 32 32 32 32 32 32 32 32 32 32 32 32 32 32 22 12 12 18 12 12 18 12 39 32 32 22 12 12 12 12 18 18
18 18 18 18 18 18 18 18 18 18 18 18 12 18 31 14 14 14 14 14 14 14 14 14 14 14 14 14 14 14 14 14 36 22 12 12 12 12 12 39 34 14 14 20 12 12 12 12 18 18 
18 18 18 18 18 18 18 18 18 18 18 18 18 12 31 14 14 14 14 14 14 14 14 14 14 14 14 14 14 14 14 14 14 36 32 32 32 32 32 34 14 14 14 20 12 12 12 12 18 18
18 18 18 18 18 18 18 18 18 18 18 18 18 12 31 14 10 10 10 16 10 10 17 10 14 14 14 14 14 14 14 14 14 14 14 14 14 14 14 14 14 14 14 20 18 12 12 12 18 18
18 18 18 18 18 18 18 12 18 12 18 12 12 18 31 14 10 33 19 19 19 19 19 19 19 19 19 19 19 19 38 14 14 14 14 14 14 14 14 14 14 14 14 20 12 12 12 12 18 18 
18 18 18 18 12 12 39 32 32 32 32 32 32 32 34 14 10 20 12 12 18 12 18 12 12 12 12 12 18 12 31 14 14 14 14 14 14 14 14 14 14 14 14 20 12 12 12 12 18 18 
18 18 18 18 12 12 31 14 14 14 14 14 14 14 14 16 16 20 12 12 18 12 12 18 18 12 12 12 18 12 31 14 14 14 14 28 24 24 24 24 24 27 14 20 12 12 12 12 18 18 
18 18 18 18 12 12 31 14 14 14 14 14 14 14 14 17 16 20 12 12 12 12 18 12 12 12 12 12 12 12 31 14 14 14 14 29 37 37 37 37 37 26 14 36 22 12 12 12 12 18 
18 18 18 18 18 12 31 14 11 11 11 11 11 14 14 16 10 36 32 32 32 32 32 32 32 32 32 32 32 32 34 14 16 28 24 37 37 37 37 37 25 14 14 16 36 22 12 12 12 18 
18 18 18 18 12 12 31 14 11 13 13 13 11 14 14 16 17 10 10 17 10 17 16 17 10 17 10 16 17 10 10 10 10 29 37 37 37 37 37 37 25 14 14 17 14 20 12 12 12 12 
18 18 18 18 12 18 31 14 11 13 13 13 11 14 14 14 14 17 10 16 16 10 10 10 16 10 16 17 14 14 14 14 14 30 37 37 37 37 37 37 37 27 14 10 10 20 12 12 18 18 
18 18 18 18 12 18 31 14 11 13 13 13 11 14 14 14 14 14 14 16 16 16 10 10 17 16 10 16 14 14 14 14 14 14 29 37 37 37 37 37 37 25 14 14 14 20 12 12 18 18 
18 18 18 18 12 12 31 14 11 13 13 13 11 14 14 14 14 14 14 14 16 16 10 15 16 16 17 14 14 14 14 14 14 14 29 37 37 37 37 37 37 25 14 14 33 21 12 12 18 18 
18 18 18 18 12 12 31 14 11 11 10 11 11 14 14 14 14 14 14 14 14 16 16 15 10 16 14 14 14 14 14 14 14 14 30 37 37 37 37 37 37 26 14 33 21 12 12 12 18 18 
18 18 18 18 12 12 31 14 14 17 10 14 14 14 14 14 14 14 14 14 14 14 16 15 16 14 14 14 14 14 14 14 14 14 14 30 23 23 37 23 26 14 14 20 12 12 12 12 18 18 
18 18 18 18 12 12 31 14 14 14 10 14 14 14 14 14 14 14 14 14 14 14 10 15 10 14 14 14 14 14 14 14 14 14 14 14 14 14 15 10 14 14 14 20 12 12 12 12 18 18 
18 18 18 18 12 12 31 14 14 14 10 14 14 14 14 14 14 14 14 14 14 14 16 15 10 14 14 14 14 14 14 14 14 14 14 14 14 14 15 14 14 14 14 20 12 12 12 12 18 18 
18 18 18 18 12 12 31 14 14 14 10 14 14 14 14 14 14 14 14 14 14 17 16 15 16 10 14 14 14 14 14 14 14 14 14 14 14 14 15 14 14 14 33 21 12 12 12 12 12 12 
18 18 18 18 12 12 31 14 10 10 10 14 14 14 14 14 14 14 14 14 10 10 17 15 16 17 16 14 14 14 14 14 14 14 14 14 14 17 15 14 14 14 20 12 12 12 12 12 18 18 
18 18 18 18 18 18 31 14 10 14 14 14 14 14 14 14 14 14 14 17 16 17 16 15 16 17 10 10 14 14 14 14 14 14 14 14 14 16 15 16 14 14 20 12 12 12 12 12 18 18 
18 18 18 18 12 12 31 14 10 14 14 14 14 14 14 14 14 14 16 16 16 14 10 15 10 14 10 16 10 14 14 14 14 14 14 16 28 35 26 14 14 14 20 12 12 12 12 12 18 18 
18 18 18 18 12 12 31 14 10 14 14 14 14 14 14 14 14 10 10 10 10 10 16 15 17 10 10 17 10 10 14 14 14 14 14 16 15 10 14 14 14 14 36 22 12 12 12 12 12 12 
18 18 18 18 12 12 31 14 10 14 14 14 14 14 14 10 10 17 16 16 17 16 16 15 16 16 16 10 16 16 16 10 10 10 10 16 15 10 14 14 14 14 14 20 12 12 12 12 18 18
18 18 18 18 12 12 31 14 10 14 14 16 35 35 35 35 35 35 35 35 35 35 35 37 35 35 35 35 35 35 35 35 35 35 35 35 25 10 14 14 14 14 14 20 12 12 12 12 18 18
18 18 18 18 12 12 31 14 10 14 14 14 10 17 10 10 10 10 10 16 16 16 16 15 16 16 16 10 10 16 16 10 10 17 16 16 15 10 10 14 14 14 14 20 12 12 12 12 18 18
18 18 18 18 12 12 31 14 10 14 14 14 10 17 10 10 10 10 10 10 16 10 16 15 16 10 16 17 14 14 14 14 14 14 14 14 15 17 14 14 14 14 14 20 12 12 12 12 18 18 
12 12 12 12 12 12 31 14 10 14 14 14 10 14 14 14 14 14 14 16 10 16 17 15 16 16 17 14 14 14 14 14 14 14 14 14 15 10 14 14 14 14 14 20 12 12 12 12 18 18
18 18 18 18 12 12 31 14 10 14 14 14 10 10 10 14 14 14 14 14 16 10 10 15 10 16 14 14 14 10 10 10 14 14 14 14 15 17 14 14 14 14 14 20 12 12 12 12 18 18
18 18 18 18 12 12 31 14 10 14 14 14 14 14 10 14 14 14 14 14 14 17 10 15 17 14 14 14 14 16 16 14 14 14 14 14 15 10 14 14 14 14 14 20 12 12 12 12 18 18
18 18 18 18 12 12 31 14 10 14 14 14 14 14 16 14 14 14 14 14 14 14 16 15 10 14 14 14 14 14 14 16 14 14 14 10 15 16 14 14 14 14 14 20 12 12 12 12 18 18
18 18 18 18 12 12 31 14 10 14 14 14 14 14 16 14 14 14 14 14 14 14 16 15 10 14 14 14 42 14 10 14 14 14 14 14 15 10 14 14 14 14 14 20 12 12 12 12 18 18 
18 18 18 18 12 12 31 14 10 10 17 10 16 16 10 14 14 14 14 14 14 14 10 15 16 14 14 14 10 14 10 14 14 14 14 14 15 10 14 14 14 14 14 20 12 12 12 12 18 18
18 18 18 18 39 32 34 14 16 16 10 16 10 10 10 14 14 14 14 14 14 10 10 15 10 16 10 10 10 14 14 14 14 14 14 14 16 16 14 14 14 14 14 20 12 12 12 12 18 18 
18 18 18 18 31 17 10 14 10 10 10 10 17 10 10 14 14 14 14 14 10 10 17 15 16 14 14 14 14 14 14 14 14 14 14 10 10 10 14 14 14 14 14 20 12 12 12 12 18 18
18 18 18 18 31 10 14 14 16 17 16 10 10 10 10 14 14 14 14 16 10 17 10 15 17 16 14 14 14 14 14 14 14 14 14 16 10 14 14 14 14 14 14 20 12 12 12 12 18 18
18 18 18 18 31 14 14 16 10 10 10 10 10 16 10 14 14 14 17 17 17 10 17 15 10 16 10 14 14 14 14 14 14 14 14 16 10 14 14 14 14 14 14 20 12 12 12 12 18 18 
18 18 18 18 40 38 10 14 10 16 10 16 16 10 10 14 14 16 10 16 10 10 10 15 16 16 17 16 14 14 14 14 14 14 14 10 10 14 14 14 14 14 14 20 12 12 12 12 18 18
18 18 18 18 18 40 38 14 14 14 14 14 14 14 14 14 10 17 10 10 10 10 16 15 16 17 10 17 16 14 14 14 14 14 14 16 10 10 14 14 14 14 14 20 12 12 12 12 18 18
18 18 18 18 18 18 31 14 14 14 14 14 14 14 14 16 16 10 17 10 10 10 16 10 10 10 10 16 17 10 14 14 14 14 10 10 17 10 10 14 14 14 14 20 12 12 12 12 18 18
18 18 18 18 18 18 31 16 17 10 10 17 10 33 19 19 19 19 19 38 10 10 16 17 10 10 17 10 10 17 10 16 16 10 10 17 10 10 10 14 14 14 14 20 12 12 12 12 18 18
18 18 18 18 18 18 40 19 19 19 19 19 19 21 12 12 12 12 12 40 19 19 19 19 19 19 19 19 19 38 14 14 14 14 33 19 19 19 19 19 19 19 19 21 18 18 18 18 18 18 
18 18 18 18 18 18 12 18 12 18 12 12 12 18 18 18 12 12 12 12 12 18 18 18 12 12 12 12 12 40 19 19 19 19 21 18 18 18 12 12 12 12 18 18 18 18 18 18 18 18
18 18 18 18 18 18 18 18 18 18 18 18 12 12 12 12 18 18 18 18 18 18 18 18 18 18 18 18 12 12 12 12 18 18 18 18 18 18 12 12 12 12 18 18 18 18 18 18 18 18
18 18 18 18 18 18 18 18 12 18 12 18 12 18 12 12 12 12 18 18 12 12 12 18 12 12 12 12 18 18 12 12 12 12 18 18 12 12 12 12 18 18 18 18 18 18 18 18 18 18
18 18 18 18 18 18 18 18 18 18 18 18 18 18 18 18 18 12 12 18 18 18 18 18 12 12 12 12 18 18 18 18 18 18 18 18 18 18 18 18 18 18 18 18 18 18 18 18 18 18
18 18 18 18 18 18 18 18 18 18 18 18 18 18 18 18 18 18 18 18 18 18 18 18 18 18 18 18 18 18 18 18 18 18 18 18 18 18 18 18 18 18 18 18 18 18 18 18 18 18